{
  "公嚬": "公噸",
  "公頤": "公噸",
  "公噉": "公噸",
  "公燉": "公噸",
  "公頓": "公噸",
  "公墩": "公噸",
  "公遁": "公噸",
  "底盡": "底盤",
  "底盆": "底盤",
  "號瑪": "號碼",
  "號碣": "號碼",
  "公只": "公尺",
  "公呎": "公尺",
  "公厘": "公釐",
  "rnm": "mm",
  "rnn": "mm"
}
